 & - entrance
@ - exit

       #-#-#-#-#-#-#-# # #
       | |        \  | | |
       # # #-#-#-# # # # #
       | |       | | | | |
       # # #-# # #-# # # #
       | | |  \|   | | | |
       # # #-# # #-# # # #
       |   | | | | |  / X
       # #-# # & # #-# # #
       | | |     | | | | |
       # # # #-# # # # # #
       | | |   |   | | | |
       # # #-#-#-#-# # # #
       |       | | |   | |
       # #-#-# # # #-#-# #
       | |   | | |   |
       # # # # # #-# # # @
       |\| |    \    | | |
       # # #-#-# # #-# # #
       | | |           | |
       # # # #-#-#-# #-# #
          \|     |   |   |
       #-#-#-#-#-#-#-#-#-#












