########################################################################################################################################################
###############----------------###########---------------#################################################------########---------#######################
---########-------##------------######----------##---------##############------------###################-----------##----------#----###############-----
-------#####----------------------##-------------#------------########-----------------#############-----######----------------###------#######---------
------------------------------------------------------------------#####-------------###########---------########-----------------#----------------------
----------------------------------------------------------------------------------------------------++++++++++++++------------------------------+-------
------------------------------------------------------------------------------------------------+++++++++++++++++++++-----------------------------+-----
----------------------------------------------------------------------------------------------++++++++++++++++++++++++++--------------------------++----
--------+++--++++--------------------+++-------------------------------------------------------++++++++++++++----++++++++--------------------------+----
---------+++++++++++------------++++++++++-----+++----------------------------------------------++++++++++++------+++++++--------++----------------++---
---------+++++++++++++++-----+++++++++++++++--+++------------------------------------------------++++++++++-------++++++--------+-------------------+---
--------++++++++++++++++++--++++++++++++++++++++JB------------++------------------------------------++++++++------+++++-------------------------------+-
--------++++++++++++++++++++++++++++++++++++++++++----------+++++---------------------------------------+++++----++++----------------------+++----------
---------++++++++++++++++++++++++++++++++++++++++---------++++++++------------------------------+---------+++----------------------------++++++---------
---------++++++Q+++++++++++++++++++++++++++++++----------++++++++--------------------------------++---------++--------------------------+++++++---------
----------++++++++++++++++++++++++++++++++++++-----------+++++++---------------------------------+++---------++------------------------m++++++++--------
-----------+++++++++++++++++++++++++++++++++++------------++++++++-------------------------------+------------+-----------------------++++++++----------
------------++++++++L+E+++++++++++++++++++++++++-----------+++++++--------------------------------------------------------------------+++++++-----------
------------++++++++++++++++++++O++++++++++++++++-----------+++++++----------------------------------------++--------------------------n++++++----------
-----------+++++++++++++++++++++++++++++++++++++--------------++++---------------------------------------+++-----+-----------------------+++++----------
-----------++++++++++++++++++++++++++++++++++++++--------------+Hj-----------------------------------++++++++------+-----------------------++++---------
---------+++++++++++F+++++++++++++++T+++++++++++++------------------------------^^-----------------+++++++++++------++-----------------------+++--------
--------++++++++++++++++++++++C+++++++++N++++++++++--------------------------^^^++-------------+++++++++++++++++-----+++---------------------^+^--------
-------dR+++------++++++-----+++A+++--a------+++++++-----------------------^++++--------------+++++++++++++++++++----++++++------------------^^---------
--------+++------------------------------------+++++----------------------^+D++---------------+++++++++++++++++++++++++++++++---------------^+----------
------------------------------------------------+++----------------------^++-+----------------+++++++++++++++++++++++++++++++++++------------^----------
-------------------------------------------------+-------------------------------------------+++++++++++++++++++++++++++++++++++++----------------------
--------------------------------------------------------------------------------------------++++++++++++++++++++++++++++++++++++++----------------------

-----++---c+++-------------------------------------------------------------------------------++++++++++++++++++++++++++++++++++++-----------------------
----+++++++++++--------------------------------------------------------------------------------++++++++++++++++++++++++++++++++++-----------------------
----+++++++++++----------------------------------k+^---------------------------------------------+++++++++++++++++++++++++++++++---------------+--------
-------++++++++-------------------&----+---------+^----------------------------------------------+++++++++++++++++++++++++++++++--+------------++-------
------------++-------------------------+---------^---------------+------------------------++--+++++++++++++++++++++++++++++++++++++------------+++------
---------------------------------------+-------------------------++------------------------+++++++++++++++++++++++++++++++++++++++---------------^+-----
---------------------------------------+--------------------------++------------------------+++++++++++++++++++++++++++++++++++++----------------^^-----
----------+++--------------------------h---------------------------++--------------------------++++++++++++++++++++++++++++++++-----------------^+^-----
-----+++++++++-------------------------------------------------+----i+---------------------------+++++++++++++++++++++++++++-----+--------------+^------
----+++++++++++--------^--------------------------------------+++---------------------------------+++++++++--------+++++++-----++++-------------^-------
----+++++++++++---+e--^^^g+----------------------------------+++++----------------------------------+++++-------------++------++----------------+-------
-----+++++++Gb----+++^++-^+----------------------------------++++-------------------------------------------+++-------------++++------------------------
-----++++++++-------^^---------------------+++------------++++++++-----------------------------------------++++-----------+++++++-----------------------
--------++++-----+f^^++-----------------+++++++++-------+++++++++-----------------------+-----------------+++-------+----++++++++++---------------------
-----------------+^----------++++----++++++++++++++---++++++++++++-----------------------+-----------------++-------+++--++++++++++++-------------------
----------------------------+++++++++++++++++++++++++++++++++++++++-----------------------+----------------------+++++++++++++++++++++----------+-------
---------------------------+++++++++++++++++++++++++++++++++++++++------------------------++----------------------++++++++++++++++++-----------++-------
----------------------------++++++++++++++++++++++++++++++++++++++------------------------++--------------------++++++++++++++++++------------++++------
----------------------------++++++++++++++++++++++++++++++++++++------------------------+++------------------+--++++++++++++++++++------------++++------
---------------------------+++++++++++++++++++++++++++++++++++--------------------------++------------------+++++++++++++++++++++-------------+++++-----
---------------------------++++++++++++++++++++++++++++++++++++-----------------------^+-------------------+++++++++++++++++++++---------------++++-----
---------++l----------------++++++++++++++++++++++++++++++++++++---------------------^---------------------+----++++++++++++-+--------+---------++++----
--------++++----------------CI+++++++++++++++++++++++++++++++++++-------------------^---------------------------+++++++++++----------+++---------+++----
-------++++------------------+++++++++++++++++++++++++++++++++++++----------------------------------------------++++++++++++--------+++-----------+++---
-------+++^------------------++++++++++++++++++++++++++++++++++++----------------------------------------------++++++++++++-------------------------+---
-------++++------------------++++++++++++++++++++++---------+++++++-------------------------------------------++++++++++++------------------------------
--------++^-------------------++++++++++++++++++++-----------^^++++------------------------------------------++++++++-++++------------------------------
-----------^-------------------++++--+++++++++++-^---+++----^^--++-----------------------------------------+++++++----++++------------------------------
------------^-------------------+++----++++++++---^-+++---^^^--+-----------------------------------------++++++---------++------------------++----------
-----------------------------------------++++++----^-+++^^^--------------------------------------------++++--------------------------------++-----------
-------------------------------------------+++++----^^^^^---------------------------------------------------------------------------------+-------------
---------------------------------------------++++-----^^---------------------------------------------------------------------------------+--------------
--------------------------------------------------------------------------------------------------------------------------------------------------------
--------------------------------------------------------------------------------------------------------------------------------------------------------
-----------------------------------------------------------------------------------------------------------------------##------------#------------------
-------------------#-----------------------------------------#-------------------#####--------###--------------------######--------##-------------------
----##-------------##-----------#####------------------------##-----------###############------###--------------##############---------#########--------
--#####------###-------------############----------######-------------######################-------------------#######################################--
########################################################################################################################################################


& : 0, 0
+ : Land
- : Water
^ : Coral Reef
# : Ice
* : Fast Currents
@ : Block Location
1 : NPC Ship
% : Storm Clouds

A : Tirun docks / Tirun landing point
B : Helgrath docks
C : Rhondale docks
D : Inferi docks

E : Distopia sky
F : Muabark Desert sky
G : Merkkirri landing point
H : Purgatory landing point
I : Rhondale landing point
J : Helgrath landing point
L : Lodos landing point
N : Arlon landing point
O : Corinthor landing point
Q : Roston landing point
R : Tenebrae landing point
T : Citrin sky

a : Tirun beach
b : Merkkirri beach
c : Dunsinane beach
d : Tenebrae beach
e : Til beach
f : Sorn beach
g : Dou beach
h : Crab Island beach
i : Devil's Arm beach
j : Purgatory beach
k : Illuminati hall beach
l : Tombar beach / Tombar sky
m : Dragonlands beach

