###  # #
 # ## # ### # 
  ## ### ### ##
        ### ### ## 
           ## ### ###
             ## #### ##
              ## # ## #
                ### ## ##
                   # ### #
                    ### ###
                       ## ##
                       # # ##  
                        # # ###
                         # ## ##
                         ###  #
                        # #### #
                        ## # ##
                        # # #
                         ###
                        # # #
                         # ##
                       ## ##
                      #  ## #
                       ##  ##
                       # ##
                      # #  # 
                     ##  ##
                    #  ##
                     ###
                     ##
                      #
